/nutrition	/sports-nutrition
/nutrition/sports-nutrition	/sports-nutrition
/nutrition/sports-nutrition/proteins	/sports-nutrition/protein
/nutrition/sports-nutrition/creatine	/sports-nutrition/pre/post-workout/creatine
/nutrition/sports-nutrition/pre-workout	/sports-nutrition/pre/post-workout/pre-workout
/nutrition/sports-nutrition/intra-workout	/sports-nutrition/pre/post-workout
/nutrition/sports-nutrition/post-workout	/sports-nutrition/pre/post-workout
/nutrition/sports-nutrition/weight-gainer	/sports-nutrition/protein/mass-gainer
/nutrition/sports-nutrition/glutamine	/sports-nutrition/pre/post-workout/glutamine
/nutrition/sports-nutrition/Bars-Energy-Drinks	/sports-nutrition/protein/protein-bars
/nutrition/sports-nutrition/fat-burner	/sports-nutrition/weight-management/fat-burner
/nutrition/sports-nutrition/more...	/sports-nutrition/workout-essentials/other-support
/nutrition/sports-nutrition/shakers-accessories	/sports-nutrition/accessories/shakers
/nutrition/sports-nutrition/muscle-building-combos	/sports-nutrition/protein/super-savers
/nutrition/sports-nutrition/nutrition-plan	/sports-nutrition/weight-management/diet-plans
/nutrition/weight-management	/sports-nutrition/weight-management
/nutrition/weight-management/fat-burner	/sports-nutrition/weight-management/fat-burner
/nutrition/weight-management/appetite-control	/sports-nutrition/weight-management/appetite-control
/nutrition/weight-management/weight-maintenance	/sports-nutrition/weight-management
/nutrition/weight-management/meal-replacement	/sports-nutrition/weight-management/meal-replacement
/nutrition/weight-management/low-calorie-food	/health-nutrition/weight-management/low-calorie-food
/nutrition/weight-management/sweetener	/sports-nutrition/weight-management/sweeteners
/nutrition/weight-management/diet-plan	/sports-nutrition/weight-management/diet-plans
/nutrition/fitness-accessories	/sports/fitness-accessories
/nutrition/fitness-accessories/abs-core	/sports/fitness-accessories/abs-core
/nutrition/fitness-accessories/abs-core/pilates-yoga	/sports/fitness-accessories/abs-core/pilates-yoga
/nutrition/fitness-accessories/abs-core/fitness-mats	/sports/fitness-accessories/abs-core/fitness-mats
/nutrition/fitness-accessories/abs-core/gym-balls	/sports/fitness-accessories/abs-core/gym-balls
/nutrition/fitness-accessories/abs-core/abs-oblique-trainers	/sports/fitness-accessories/abs-core/abs-oblique-trainers
/nutrition/fitness-accessories/strength-training	/sports/fitness-accessories/strength-training
/nutrition/fitness-accessories/strength-training/upper-body	/sports/fitness-accessories/strength-training/upper-body
/nutrition/fitness-accessories/strength-training/arm-leg-weights	/sports/fitness-accessories/strength-training/arm-leg-weights
/nutrition/fitness-accessories/strength-training/medicine-balls	/sports/fitness-accessories/strength-training/medicine-balls
/nutrition/fitness-accessories/strength-training/dumbbells	/sports/fitness-accessories/strength-training/dumbbells
/nutrition/fitness-accessories/strength-training/kettlebells	/sports/fitness-accessories/strength-training/kettlebells
/nutrition/fitness-accessories/aerobics-general-fitness	/sports/fitness-accessories/aerobics-general-fitness
/nutrition/fitness-accessories/aerobics-general-fitness/aerobic-steppers	/sports/fitness-accessories/aerobics-general-fitness/aerobic-steppers
/nutrition/fitness-accessories/aerobics-general-fitness/hand-grips	/sports/fitness-accessories/aerobics-general-fitness/hand-grips
/nutrition/fitness-accessories/aerobics-general-fitness/jump-ropes	/sports/fitness-accessories/aerobics-general-fitness/jump-ropes
/nutrition/fitness-accessories/aerobics-general-fitness/resistance-bands	/sports/fitness-accessories/aerobics-general-fitness/resistance-bands
/nutrition/fitness-accessories/support-gear	/sports/fitness-accessories/support-gear
/nutrition/fitness-accessories/support-gear/hand-wrist	/sports/fitness-accessories/support-gear/hand-wrist
/nutrition/fitness-accessories/support-gear/back	/sports/fitness-accessories/support-gear/back
/nutrition/fitness-accessories/support-gear/knee	/sports/fitness-accessories/support-gear/knee
/nutrition/fitness-accessories/support-gear/elbow	/sports/fitness-accessories/support-gear/elbow
/nutrition/fitness-accessories/support-gear/thighs	/sports/fitnessaccessories/support-gear/thighs
/nutrition/fitness-accessories/support-gear/ankle	/sports/fitnessaccessories/support-gear/ankle
/nutrition/fitness-accessories/rehabilitation-supports	/sports/fitness-accessories/rehabilitation-supports
/nutrition/fitness-accessories/combos	/sports/fitness-accessories/combos
/nutrition/fitness-accessories/miscellaneous-accessories	/sports/fitness-accessories/miscellaneous-accessories
/nutrition/fitness-accessories/sklz	/sports/fitness-accessories/sklz
/nutrition/dietary-supplements	/health-nutrition/dietary-supplements
/nutrition/dietary-supplements/multivitamins	/health-nutrition/dietary-supplements/vitamins
/nutrition/dietary-supplements/multivitamins/men-s-health	/health-nutrition/shop-by-need/men-health
/nutrition/dietary-supplements/multivitamins/women-s-health	/health-nutrition/shop-by-need/women-health
/nutrition/dietary-supplements/multivitamins/teen-s-health	/health-nutrition/shop-by-need/children
/nutrition/dietary-supplements/vitamin-a-z	/health-nutrition/dietary-supplements/vitamins
/nutrition/dietary-supplements/all-minerals	/health-nutrition/dietary-supplements/minerals
/nutrition/dietary-supplements/anti-oxidant	/health-nutrition/dietary-supplements/anti-oxidants
/nutrition/dietary-supplements/fishoil-omegas	/health-nutrition/dietary-supplements/omegas-fish-oil-flax
/nutrition/dietary-supplements/hair-skin-nails	/health-nutrition/shop-by-need/hair-skin-nails
/nutrition/dietary-supplements/bones	/health-nutrition/shop-by-need/bone-muscle
/nutrition/dietary-supplements/eye	/health-nutrition/shop-by-concern/eye-health
/nutrition/dietary-supplements/herbal-cleanser	/health-nutrition/dietary-supplements/herbs
/nutrition/dietary-supplements/herbal-teas	/health-nutrition/healthy-food/beverages
/nutrition/dietary-supplements/herbs-a-z	/health-nutrition/dietary-supplements/herbs
/nutrition/condition-specific-supplements	/health-nutrition/dietary-supplements/condition-specific
/nutrition/condition-specific-supplements/cardiovascular	/health-nutrition/dietary-supplements/omegas-fish-oil-flax
/nutrition/condition-specific-supplements/joint-muscle	/health-nutrition/shop-by-concern/arthritis-support
/nutrition/condition-specific-supplements/stress-anxiety	/health-nutrition/shop-by-concern/other-concerns
/nutrition/condition-specific-supplements/digestion	/health-nutrition/shop-by-concern/other-concerns
/nutrition/condition-specific-supplements/immunity	/health-nutrition/shop-by-concern/immunity
/nutrition/condition-specific-supplements/blood-sugar	/health-nutrition/shop-by-concern/diabetes-support
/nutrition/condition-specific-supplements/brain-memory	/health-nutrition/shop-by-concern/other-concerns
/nutrition/condition-specific-supplements/vitality	/health-nutrition/shop-by-need/sexual-wellness
/nutrition/condition-specific-supplements/energy-endurance	/health-nutrition/shop-by-concern/other-concerns
/nutrition/condition-specific-supplements/daily-nutrition-combos	/health-nutrition/shop-by-concern/other-concerns
/nutrition/specialty-nutrition	/health-nutrition/healthy-food
/nutrition/specialty-nutrition/ayurveda	/health-nutrition/alternative-remedies
/nutrition/specialty-nutrition/ayurveda/skin-hair-care	/health-nutrition/alternative-remedies
/nutrition/specialty-nutrition/ayurveda/cardiovascular	/health-nutrition/alternative-remedies
/nutrition/specialty-nutrition/ayurveda/joint-muscle	/health-nutrition/alternative-remedies
/nutrition/specialty-nutrition/ayurveda/stress-anxiety	/health-nutrition/alternative-remedies
/nutrition/specialty-nutrition/ayurveda/digestion	/health-nutrition/alternative-remedies
/nutrition/specialty-nutrition/ayurveda/kidney-care	/health-nutrition/alternative-remedies
/nutrition/specialty-nutrition/ayurveda/Stones	/health-nutrition/alternative-remedies
/nutrition/specialty-nutrition/ayurveda/hangover-pills	/health-nutrition/alternative-remedies
/nutrition/specialty-nutrition/ayurveda/uterine-tonic	/health-nutrition/alternative-remedies
/nutrition/specialty-nutrition/ayurveda/respiratory-care	/health-nutrition/alternative-remedies
/nutrition/specialty-nutrition/ayurveda/liver-care	/health-nutrition/alternative-remedies
/nutrition/specialty-nutrition/ayurveda/sleep-care	/health-nutrition/alternative-remedies
/nutrition/specialty-nutrition/ayurveda/piles-fistula	/health-nutrition/alternative-remedies
/nutrition/specialty-nutrition/ayurveda/laxative	/health-nutrition/alternative-remedies
/nutrition/specialty-nutrition/ayurveda/natural-protein	/health-nutrition/alternative-remedies
/nutrition/specialty-nutrition/ayurveda/immunity	/health-nutrition/alternative-remedies
/nutrition/specialty-nutrition/ayurveda/diet-pills	/health-nutrition/alternative-remedies
/nutrition/specialty-nutrition/ayurveda/anti-allergy	/health-nutrition/alternative-remedies
/nutrition/specialty-nutrition/ayurveda/fibre	/health-nutrition/alternative-remedies
/nutrition/specialty-nutrition/ayurveda/juices	/health-nutrition/alternative-remedies
/nutrition/specialty-nutrition/ayurveda/blood-sugar	/health-nutrition/alternative-remedies
/nutrition/specialty-nutrition/ayurveda/brain-memory	/health-nutrition/alternative-remedies
/nutrition/specialty-nutrition/ayurveda/vitality	/health-nutrition/alternative-remedies
/nutrition/specialty-nutrition/ayurveda/revitalize	/health-nutrition/alternative-remedies
/nutrition/specialty-nutrition/gluten-free-food	/health-nutrition/healthy-food/gluten-free
/nutrition/specialty-nutrition/organic-food	/health-nutrition/healthy-food/organic
/nutrition/specialty-nutrition/diabetic-food	/health-nutrition/healthy-food/disorder-specific
/nutrition/specialty-nutrition/disorder-specific	/health-nutrition/healthy-food/disorder-specific
/nutrition/specialty-nutrition/healthy-food	/health-nutrition/healthy-food
/nutrition/specialty-nutrition/healthy-food/snacks	/health-nutrition/healthy-food/breakfasts-and-snacks
/nutrition/specialty-nutrition/healthy-food/cereals	/health-nutrition/healthy-food/breakfasts-and-snacks
/nutrition/specialty-nutrition/healthy-food/bars	/health-nutrition/healthy-food/breakfasts-and-snacks
/nutrition/specialty-nutrition/healthy-food/food-preparations	/health-nutrition/healthy-food/food-preparation
/nutrition/specialty-nutrition/healthy-food/daily-need	/health-nutrition/healthy-food/food-preparation
/nutrition/specialty-nutrition/infants	/health-nutrition/shop-by-need/children
/nutrition/specialty-nutrition/kids	/health-nutrition/shop-by-need/children
/nutrition/specialty-nutrition/mother	/health-nutrition/shop-by-need/post-pregnancy